#############################‬‬
#..1..............G......5..#‬‬
#####...E...................#‬‬
#...#.......####.......######‬‬
#..##......6...#..##...#..4.#‬‬
#..........E...#3..#........#‬‬
#....G.........E.###...######‬‬
#........#######............#‬‬
#......2E......#.#...G...H..#‬‬
#.............7#.#....E.....#‬‬
#############################‬‬